MAP 19 6 5
AAA AAA AAA AAA AAA AAA AAA AAA AAA GvV AAA AAA AAA AAA AAA AAA AAA AAA AAA
AAA AAA AAA AAA AAA AAA AAA AAA GZ7 AAA AAA AAA AAA AAA AAA AAA AAA AAA AAA
AAA AAA AAA AAA AAA AAA AAA AAA AAA AAA AAA AAA AAA AAA AAA AAA AAA AAA AAA
AAA AAA AAA Bt3 AAA AAA AAA AAA AAA AAA AAA AAA AAA AAA AAA AAA AAA AAA AAA
AAA AAA AAA AAA AAA AAA AAA AAA AAA AAA AAA AAA AAA AAA Fu/ AAA AAA AAA AAA
AAA AAA AAA AAA AAA AAA AAA AAA AAA AAA AAA AAA AAA AAA AAA AAA AAA AAA AAA

AAA AAA AAA AAA AAA AAA AAA AAA AAA AAA AAA AAA Gnf AAA AAA AAA AAA AAA AAA
AAA AAA AAA AAA AAA AAA AAA AAA AAA AAA AAA AAA An/ AAA AAA AAA AAA AAA AAA
AAA AAA AAA AAA AAA AAA Fva AAA AAA AAA AAA AAA AAA AAA AAA AAA AAA AAA AAA
AAA AAA AAA AAA AAA AAA AAA AAA AAA AAA AAA AAA AAA Emn AAA AAA AAA AAA AAA
AAA AAA AAA AAA AAA AAA AAA AAA Fqb AAA AAA AAA AAA AAA AAA AAA AAA AAA AAA
AAA AAA AAA AAA AAA AAA AAA AAA AAA AAA AAA AAA AAA AAA AAA AAA AAA AAA AAA

AAA AAA AAA AAA AAA AAA AAA AAA AAA AAA AAA AAA AAA AAA AAA AAA AAA AAA AAA
AAA AAA AAA AAA AAA AAA AAA AAA AAA AAA AAA AAA AAA AAA AAA Der AAA AAA AAA
AAA AAA AAA AAA AAA AAA AAA AAA AAA AAA AAA AAA AAA AAA AAA AAA AAA AAA AAA
AAA AAA AAA AAA AAA AAA De7 AAA AAA AAA AAA AAA AAA AAA AAA AAA AAA AAA AAA
AAA AAA AAA AAA AAA AAA AAA AAA AAA AAA AAA AAA AAA AAA AAA AAA AAA AAA AAA
AAA AAA AAA Bd1 AAA AAA AAA AAA AAA AAA AAA AAA AAA AAA AAA AAA AAA AAA AAA

AAA AAA AAA AAA AAA AAA AAA AAA AAA AAA AAA AAA AAA AAA AAA AAA AAA AAA AAA
AAA AAA AAA AAA AAA AAA AAA AAA Avb AAA AAA AAA AAA AAA AAA AAA AAA AAA CXt
AAA E66 AAA AAA AAA AAA AAA AAA EZ1 AAA AAA AAA AAA AAA HZ5 AAA Hbq AAA AAA
AAA AAA AAA AAA AAA AAA AAA AAA AAA AAA AAA AAA AAA AAA AAA AAA AAA AAA AAA
AAA AAA AAA AAA AAA AAA AAA AAA AAA AAA AAA AAA AAA AAA AAA AAA AAA AAA AAA
AAA AAA AAA AAA AAA AAA AAA AAA AAA AAA AAA AAA AAA Alt BeZ AAA Af2 AAA AAA

AAA AAA AAA H+a AAA Hbl AAA AAA AAA AAA AAA AAA AAA AAA AAA FuW AAA AAA AAA
AAA AAA AAA AAA AAA AAA AAA AAA AAA AAA AAA AAA AAA AAA AAA AAA AAA AAA AAA
AAA AAA AAA AAA AAA AAA AAA AAA AAA AAA AAA AAA AAA AAA AAA AAA AAA AAA AAA
AAA AAA AAA AAA AAA AAA AAA AAA AAA AAA AAA AAA AAA AAA AAA AAA AAA AAA AAA
AAA AAA AAA AAA AAA AAA AAA AAA AAA AAA FZV AAA AAA AAA AAA AAA AAA AAA AAA
AAA AAA AAA AAA EaZ AAA AAA AAA AAA AAA AAA AAA AAA AAA AAA AAA AAA AAA B2V
ENDMAP
START 15 5 1
