MAP 5 5 1
AAA AAA AAA Gd/ AAA
AAA AAA AAA AAA AAA
AAA AAA GlZ AAA Ar7
AAA AAA Cdm AAA AAA
AAA AAA AAA AAA AAA
ENDMAP
START 1 2 0
