MAP 6 4 3
AAA AAA AAA AAA AAA AAA
AAA AAA AAA AAA AAA AAA
AAA AAA AAA AAA AAA AAA
AAA AAA AAA AAA AAA AAA

AAA AAA AAA AAA AAA AAA
AAA AAA AAA B// AAA AAA
AAA AAA AAA B// AAA AAA
AAA AAA AAA AAA AAA AAA

AAA AAA AAA AAA AAA AAA
AAA AAA AAA B// AAA AAA
AAA AAA AAA B// AAA AAA
AAA AAA AAA AAA AAA A//
ENDMAP
START 0 0 0
