MAP 6 4 3
AAA AAA AAA AAA AAA AAA
AAA AAA AAA AAA AAA AAA
AAA AAA AAA AAA AAA AAA
AAA AAA AAA AAA AAA AAA

AAA AAA AAA AAA AAA AAA
AAA AAA AAA AAA AAA AAA
AAA AAA AAA AAA AAA AAA
AAA AAA AAA AAA AAA E//

A// AAA AAA AAA AAA AAA
AAA AAA AAA AAA AAA AAA
AAA AAA AAA AAA AAA AAA
AAA AAA AAA AAA AAA AAA
ENDMAP
START 0 0 0
